0000101011
0101101000
0101100010
0100001110
0111111000
0000000111
1100000001
