00001111100000110001010010011111100010001110100000
01100010001110010100001001011111110110101000001010
00110100101111000110101011001100110000100011101100
10000101000110101110100000100010011011001011101001
10110000010000101100011110001001000000101000000011
01011011001011000101001100101100101010000101010110
00001000100000010000011101000010000000110000110000
10100010101101100110110000010100110110111010000101
11101000000000001000000101010001110000010001010001
11001010110110101101110110000101110101000101101100
00011000000100000010110000110110000111110000001101
01000010101001011000110110010110110100000110100000
11110100101011111010100011010000110011011110010110
11110001000001111000011001001011001000001110110110
11101100110100110011000010100011011101101100000000
11001110000010000111011000001101001101100001010110
10010110101010101111011010100000010000001100000110
10110000001010000011000000101101110110111110101100
10000101110000101100010110001101100010001010001101
00101001111011000001110011011100001000100001100011
10101011111000010101110100011101111110110100001011
11000011111011010100000101011001111100000001100001
11011001111000000010110010000011111001011010101101
11000011110010101000001000101101111010100000001000
10011001110100010011010101100000000000101101010010
00110101010101010100000000001011011010001111000110
10100000000000000001110111011000011010100001011000
10011110101101101100010111000011000000110110001101
11000110000010001001000001011001101010000001100010
11010001011001010011010100011101001011011101001010
10010101011100111000010001100000010000110100110010
00101000110010000110100110010110100110000010000100
01000010000110110011001001000011001101011011101101
00111111010110111011010011101000011100011011100001
10000110100000111000000111100011000010100011001101
00110000101010110010110111001110011000011100010000
01111010001101000110000111100000100010111101110110
10000100100100011100101111110101110100111100000100
10101101110001000001001111110000110001100001010001
00000000110100010110101111000110000100001100110111
10101101100001100000001110010011010010101110100111
00000000001010110101100000100110001011000110001111
01010111011010100111101010110000100010010111011111
01010111011000001111100110000101010100100111001111
00000011001011100111110110110001011001110011101111
10101000100011110111110000111100010011111000100110
10001010110111110111100101011101000111111111010000
10100011000111000011101000011000111111111110001010
01101000010000011011000011000011111111111100110000
00001101000101110011011011010111111111111110000110
