0100001100
0001100010
0100011000
0001000110
0100101000
0001101010
0100000000
0011010110
1010100000
0000001010
