11110001111000000100000111100001111111000001011111000111111011111110000001000000
11110100010010101011110000101101111101010100000100110011110000111100110100011011
11000011001110000001000110000001111000010001010010011000000110011001000101011000
00011010100110101100101000101010000011000101011001000101010111000101010001000010
01011000010100000010001010100000101000010100011101010000110011110010001110010100
01001101010001011000110010011011001011000011001100010110000111101000101111000101
00100000001010001010100111000000010011101010101101000010110011001010000000010000
10001011100100100100001111011011000111001100000000010100110100010000110101000111
11110000110011010101101100000011010110010001101101000001000101010101000000010111
11111110001000000001100001101010000010110110111101010100011000000000011011010111
11111111111101010100010110100001011000000110100000001001010011101010100001000111
11111100011100010001000100001100010010110000010111101100000111101001101100110011
01100001100011000101010001101101000110000111010111000001101111000100000010110100
00001011001001111000010100000000010110101111001011011011000100010101010110010001
01010011010100001011000011101010110110001111100001011001010001101001110101001101
10011000000101100011101000001000100000101100010110000011010100000100000000100100
10101101101100001000011101010010011010000001010000110100100110110010101010001001
00100000001101100011001000001011001000101010000101000110001000011000100000100011
10101101101000001011010010100111010010001010110100011000100011001010101111001111
10001000100010111100000100110010010110110000110001100010001011110000101111011111
11011010101110111001110001000101000110010101010110001100100011100101000000011111
11000000010000111010000101010001010001000010000000111001001001001010010110101111
00010101000110110011010001001100001101101001101101011101011101010000100000001111
01000000110100000100001101101010110100010100001001001100001100001110101110101111
01010110000011101101100000000010000011010011110011100001101001011110000110000111
00000011101000001000110110101001011000000111111001110101000010011100110111010001
10101001101110100010111000000011001011011111110100110110011010111001000010010100
00100100010000010110110010111000010001011110000010000111000000111010011000100001
01001001001011001100010110001011000100001000111011010011011010010000110110001100
00010101100111101001000000100010010101100010001011001100010001000110100111100001
11110001010011100100101101010100100001110100100001101101100100110110001111101011
11110100001000010101000000000001001100000010101010001100110001110010111110000111
00000001100110100001011010101010011111101011001000100010001100111000010100110111
01011101110100001010011110001011001111100000010010011001101110011101000001010000
01011000111001010010111100100000101111101101011011011100101101001100011010001010
00001010001010001010001001101101000100001111001100000010000001010001011000100000
10100000100001100010100100010100010010101111101101011010110101000100011010101101
10101110110100001000010001000001010100000001100000000000010000010001000010001101
11001100010010101111010100101101000001101100001101101101000101011101101000101000
00010101011010101111000110011000101101000001101000100010111011001101111011001011
01000000000000000110010111100010101010011100100010011000110001100001111000010001
00011101110101110000110110001100000000110101010111000101110100010110111010101100
01111100000111101111000000101011011101000001010101011001101101000100000010000010
10001001010011001111011011000011000000011100000000010010000000111001101010101010
01100110001000011110000010011000011011001101101011000100110101001010000000001000
00110010100011001111011000111011010001100000000111010111110000100001010101100110
10011001101000100110010011000010001101110110110011000011110110110100000001110000
11000101000011110100100101011001010000110110000111101011110010001101011101110101
11010000010101110001001000010101000110000100101111101000101001100100111000110111
10001110100001100110011010100100010000110101101111100011000101110110000011000111
00111110011100001111000000010010111010110101001111101000010000100010101011010011
01110001011101010110010111011000001000100000010110000010101110011000000000011001
00000110001100000000110000000101100101001011010000101010000111000101010110111101
10101000100101101010111011010100010001100110001011000001110001010011000010101110
00001010010001000000001000010001110100110100100001010100110100001011101010000000
01101011010100010101100111000100100010100010010100000010001001100010110001011011
01100000000010100100110011010101001000011011000010101000100010010100000100111011
00001101011011001001100111100100011101011000010100101011101101000001010010000011
01100010010010011100001001101101000110000101000110001001000000011010011001101000
01101000111000100001010100000000010000110101110001100100010110110000111100100110
01001110111011110111000111011011011010110001111111110011100111000101011001001100
10010110000001100000010000000010001110010100111111111011001110011001001010011001
10100001101101101010100101101000100000100001100000000010011100101100100000111010
00011011001000000100101000011101101101101100001101011000101110100110001010000010
01001011010010110001000011000100001100000110101100011101100000010110100110101100
01100000000110000100110100010010101001010100000001001000101011000000010000000001
00101010111010110010001001011001110010010001010101100010000010101011110101010101
10000000010000110100100011001100000111100101100010111010101000000001000100100001
00101011000110100010001011101001011111001100001100011000000011011110010010001101
10000001010110001001100000100100011110010101101101000011111000001100100101110001
00110100010001100100101101010011011110110101110001101011110010100001001000110101
10010101001101110110011100011000101110110001100101110000011010110110010010100101
11000001100000000011000011001110001000000100010001110101001000000111001010101000
10011010001011101010101001101110100010101101100101110110100011101011011000000110
00101000110011000000001101110001001010001000001000100110010101111001000010110000
10000101101100010110100001110100011000100011010010001010100101011100010100001101
00110000001101010000001101100101111010001000000101100000110000001111000110100110
10001010100000001011011100001101110001101010101100001111000110100000010000010000
10100100001110101010000001101100010111000001101101101000101010001101000111100101
00010001100000000000101010000001000110011100000000000010000000100001101111101000
